00000000000000000000000000
01010100000111110111101110
01010101111100010100111010
01111111000000000000000010
01000001111110110110011110
01000001100010111100110010
01111111101110110110100010
01001001001001011011001110
01001001011011101101111010
01011001010110110110100110
01010001101101011011101100
01011101011011101101001010
01000001110110110110111110
01010100001101011011101010
01011111111011101101011100
01110101001110110110110111
00000000000000000000000000